R 1024 768

NO ./tex/11.xpm
WE ./tex/ice.xpm
EA ./tex/ice.xpm
SO ./tex/11.xpm

S  ./tex/coral_sprite.xpm

C 172, 200, 245
F 0, 78, 122


11111111111111111
10101010101010101
10000200000000001
11200E00000020001
11000000000000001
11000200000000001
10000000000000001
10000000000000001
11111111111111111
