R 1024 768

NO ./tex/no.xpm
WE ./tex/we.xpm
EA ./tex/ea.xpm
SO ./tex/so.xpm


C 23, 13, 21
F 71, 65, 70


11111111111111111111111111111
10000000001100000000000000001
10110000011100000000000010001
10010000000000000000000010001
10110000011100000000000010001
10000000001100000111011110001
11110111111111000100000010001
11110111111111011101010010001
11000000110101011100000010001
10000000000000001100000010001
10000000000000001100010000001
11000000110101000000000000001
11110111110101000000000000001
10000000001100000100000010001
10000000000000000000000001001
1000000000100001000000N001001
10000000001101000000000000001
10000000000100000001010000001
11111111111111111111111111111
