R 1024 768

NO ./tex/no.xpm
WE ./tex/we.xpm
EA ./tex/ea.xpm
SO ./tex/so.xpm


C 23, 13, 21
F 71, 65, 70


11111111111111111
10101010101010101
10000000000000001
11000E00001000001
11000000000000001
11000000000000001
10000000000000001
10000000000000001
11111111111111111
